Abstract - Абстрактный
Attitude - Отношение
Baby - Младенец
Bee - Пчела
Cat - Кот
Coffee - Кофе
Dad - Отец
Doll - Кукла
Economy - Экономия
Ewe - Овца
Fact - Факт
First - Первый
Gain - Усиление
Geek - Фанат
Happy - Счастливый
Head - Голова
Ignore - Игнорировать
Issue - Проблема
Jam - Варенье
Jeans - Джинсы
Kale - Капуста
Key - Ключ
Lazy - Ленивый
Lemon - Лимон
Mam - Мама
Meat - Мясо
Name - Имя
Nut - Орех
Obtain - Получить
Ozone - Озон
Pain - Боль
Pizza - Пицца
Question - Вопрос
Queue - Очередь
Random - Случайный
Read - Читать
Sad - Печальный
Set - Набор
Talk - Разговор
Teacher - Учитель
Ubiquitous - Вездесущий
Update - Обновить
Value - Значение
Void - Пустота
Water - Вода
Weak - Слабый
Xenon - Ксенон
Xylophone - Ксилофон
Yard - Двор
Yummy - Вкусный
Zip - Промелькнуть
Zygote - Зигота
